Columns: 40
Rows: 25
000000000000000000000000000000000000000
0000000000000000011111111100000000000000
0000000000000000001111111110000000000000
0000000000000000000011111110000000000000
0000003400000000000001111100000000000000
0000005600000000000000000000000000000000
0000003400000034343434340000000000000000
0000005600000056565656560000000000000000
0000000000000034000000000000000000000000
0000000000000056000000000000000000000000
0000000000000034000000000000000000000000
0000000000000056000000000000000000000000
0000003434343434000000340000000000000000
0000005656565656000000560000000000000000
0000000000000000000000340000000000000000
0000000000000000000000560000000000000000
0000000000000000000000000000000000000000
0000000000000000000000000000000000000000
0000000000000000000000000000000000000000
0000000000000000000000000000000000000000
0000000000000000000000000000000000000000
0000000000000000000000000000000000000000
0000000000000000000000000000000000000000
0000000000000000000000000000000000000000
0000000000000000000000000000000000000000